vendorSub : 브라우저 제조사에 의해 제공되는 부가적인 제품 정보를 나타내는 문자열 값
productSub : 브라우저 제조사가 제공하는 브라우저 버전 정보
vendor : 브라우저 제조사 이름
maxTouchPoints : 사용자의 디바이스가 지원하는 최대 터치 지점 수
scheduling : 브라우저에서 스케줄링 정보를 제공하는 Scheduling 객체
userActivation : 사용자 동작에 대한 정보를 제공하는 UserActivation 객체
doNotTrack : 사용자의 Do Not Track 설정 여부를 나타내는 값
geolocation : 브라우저의 위치 정보를 제공하는 Geolocation 객체
connection : 사용자의 네트워크 연결 정보를 제공하는 NetworkInformation 객체
plugins : 브라우저에 설치된 플러그인 정보를 제공하는 PluginArray 객체

mimeTypes: [object MimeTypeArray] 브라우저에서 지원하는 MIME 유형 목록을 담고 있는 MimeTypeArray 객체
pdfViewerEnabled: true PDF 문서를 브라우저에서 볼 수 있는 PDF 뷰어 사용 가능 여부
webkitTemporaryStorage: [object DeprecatedStorageQuota] 웹 사이트에서 사용할 수 있는 임시 저장소 용량을 제공하는 DeprecatedStorageQuota 객체
webkitPersistentStorage: [object DeprecatedStorageQuota] 웹 사이트에서 사용할 수 있는 영구 저장소 용량을 제공하는 DeprecatedStorageQuota 객체
hardwareConcurrency: 8 브라우저에서 사용 가능한 CPU 코어 수
cookieEnabled: true 쿠키를 사용할 수 있는지 여부
appCodeName: Mozilla 웹 브라우저 코드 네임
appName: Netscape 웹 브라우저 이름
appVersion: 5.0 (Windows NT 10.0; Win64; x64) AppleWebKit/537.36 (KHTML, like Gecko) Chrome/113.0.0.0 Safari/537.36 웹 브라우저 버전 및 정보
platform: Win32 브라우저가 실행 중인 플랫폼 종류

product : Gecko 브라우저 엔진 종류
userAgent : Mozilla/5.0 (Windows NT 10.0; Win64; x64) AppleWebKit/537.36 (KHTML, like Gecko) Chrome/113.0.0.0 Safari/537.36 현재 브라우저의 User-Agent 문자열
language : ko-KR 현재 브라우저에서 설정된 언어
languages : ko-KR,ko,en-US,en 브라우저에서 지원하는 언어 목록
onLine : true 현재 인터넷 연결 상태
webdriver : false 현재 브라우저가 웹드라이버를 사용하는지 여부
getGamepads : function getGamepads() { [native code] } getGamepads() 메소드로 현재 연결된 게임패드 정보를 가져올 수 있는지 여부
javaEnabled : function javaEnabled() { [native code] } 현재 브라우저에서 자바 실행 가능 여부
sendBeacon : function sendBeacon() { [native code] } sendBeacon() 메소드로 서버로 비동기식 HTTP 요청을 보낼 수 있는지 여부
vibrate : function vibrate() { [native code] } 현재 브라우저에서 진동 기능을 지원하는지 여부

bluetooth : [object Bluetooth] 블루투스 기능을 제어할 수 있는 Bluetooth 객체
clipboard : [object Clipboard] 클립보드 기능을 제어할 수 있는 Clipboard 객체
credentials : [object CredentialsContainer] 사용자 인증 정보를 제어할 수 있는 CredentialsContainer 객체
keyboard : [object Keyboard] 키보드 이벤트를 제어할 수 있는 Keyboard 객체
managed : [object NavigatorManagedData] 관리된 환경에서 브라우저가 실행 중인지 여부를 나타내는 NavigatorManagedData 객체
mediaDevices : [object MediaDevices] 미디어 입력 장치(카메라, 마이크 등)를 제어할 수 있는 MediaDevices 객체
storage : [object StorageManager] 웹 스토리지(로컬 스토리지, 세션 스토리지 등)를 제어할 수 있는 StorageManager 객체
serviceWorker : [object ServiceWorkerContainer] 서비스 워커를 제어할 수 있는 ServiceWorkerContainer 객체
virtualKeyboard : [object VirtualKeyboard] 가상 키보드를 제어할 수 있는 VirtualKeyboard 객체
wakeLock : [object WakeLock] 브라우저에서 Sleep 모드로 전환되지 않도록 방지할 수 있는 WakeLock 객체

deviceMemory : 8 디바이스의 시스템 메모리 용량
ink : [object Ink] 인크(물감) 입력 기술의 지원 여부
hid : [object HID] HID(Human Interface Device) 연결의 지원 여부
locks : [object LockManager] Lock API 지원 여부
mediaCapabilities : [object MediaCapabilities] 브라우저에서 지원하는 미디어 코덱 및 포맷을 확인하는 데 사용되는 MediaCapabilities API 지원 여부
mediaSession : [object MediaSession] Media Session API 지원 여부
permissions : [object Permissions] Permissions API 지원 여부
presentation : [object Presentation] Presentation API 지원 여부
serial : [object Serial] 시리얼 포트 지원 여부
gpu : [object GPU] 브라우저에서 GPU 가속을 지원하는지 여부

usb : [object USB] 웹 USB API를 통해 USB 장치를 검색하고 제어할 수 있는 USB 객체
windowControlsOverlay : [object WindowControlsOverlay] 브라우저 창에서 시스템 제어를 위한 오버레이 컨트롤을 포함하는 WindowControlsOverlay 객체
xr : [object XRSystem] 웹 기반의 증강 현실(AR)과 가상 현실(VR)을 지원하는 WebXR API를 사용하여 XR 환경을 제어할 수 있는 XRSystem 객체
userAgentData : [object NavigatorUAData] User-Agent 문자열에서 파생된 브라우저 및 운영 체제의 자세한 정보를 제공하는 NavigatorUAData 객체
canShare : function canShare() { [native code] } Web Share API를 사용하여 공유 가능한지 여부를 확인하는 메서드
share : function share() { [native code] } Web Share API를 사용하여 컨텐츠를 공유하는 메서드
clearAppBadge : function clearAppBadge() { [native code] } 브라우저 탭 아이콘에 표시되는 앱 뱃지를 제거하는 메서드
getBattery : function getBattery() { [native code] } 장치 배터리 상태에 대한 정보를 제공하는 Battery Status API를 사용하여 배터리 정보를 가져오는 메서드
getUserMedia : function getUserMedia() { [native code] } WebRTC API를 사용하여 웹 캠, 마이크 등의 미디어 스트림을 가져오는 메서드
requestMIDIAccess : function requestMIDIAccess() { [native code] } Web MIDI API를 사용하여 MIDI 장치를 검색하고 제어할 수 있는 MIDI 객체를 요청하는 메서드

requestMediaKeySystemAccess : function requestMediaKeySystemAccess() { [native code] } 미디어 암호화에 사용되는 키 시스템에 대한 액세스를 요청합니다.
setAppBadge : function setAppBadge() { [native code] } 브라우저의 어플리케이션 뱃지를 설정합니다.
webkitGetUserMedia : function webkitGetUserMedia() { [native code] } 사용자의 미디어 디바이스 카메라, 오디오를 브라우저에서 사용할 수 있게 허용합니다.
getInstalledRelatedApps : function getInstalledRelatedApps() { [native code] } 현재 OS에서 설치된 관련 어플리케이션들의 정보를 가져옵니다.
registerProtocolHandler : function registerProtocolHandler() { [native code] } 브라우저에 특정 URI 스키마가 등록되도록 합니다.
unregisterProtocolHandler : function unregisterProtocolHandler() { [native code] } 브라우저에서 특정 URI 스키마의 등록을 취소합니다.